#,#,#,#,#,#,#,#,#,#,#,#,#
#,#,#,M,#,#,.,.,#,#,#,49,#
#,16,15,14,13,.,.,.,#,N,#,48,#
#,17,#,#,12,#,#,3,2,1,0,47,#
#,18,O,#,11,P,Q,4,#,#,#,46,#
#,19,#,#,10,#,#,5,#,#,R,45,#
#,20,.,.,9,8,7,6,.,#,#,44,#
#,21,#,#,S,.,T,#,.,.,.,43,#
#,22,.,28,29,30,#,#,.,#,#,42,#
#,23,#,27,#,31,#,#,.,#,#,41,#
#,24,25,26,U,32,#,V,.,#,W,40,#
#,.,X,#,#,33,34,35,36,37,38,39,#
#,#,#,#,#,#,#,#,#,#,#,#,#
