#,#,#,#,#,#,#,#,#,#,#,#,#
#,14,15,16,17,18,19,20,21,22,.,.,#
#,13,A,#,#,.,#,B,#,23,#,#,#
#,12,#,#,#,.,#,#,#,24,C,#,#
#,11,.,.,.,.,.,#,#,25,#,#,#
#,10,D,#,#,#,29,28,27,26,.,.,#
#,9,#,#,#,E,30,#,F,#,.,.,#
#,8,7,6,5,.,31,#,G,#,.,#,#
#,#,H,#,4,I,32,33,34,35,36,#,#
#,#,1,2,3,#,.,#,#,#,37,J,#
#,K,0,#,.,#,.,#,L,#,38,#,#
#,48,47,46,45,44,43,42,41,40,39,#,#
#,#,#,#,#,#,#,#,#,#,#,#,#
